SO ./textures/tile_water.png

C 35,19,73

WE ./textures/studio2.png

NO ./textures/new_wall.png

EA ./textures/studio3.png

F 15,6,40

111111111111111
111111000111111
111110000011111
1111000E0001111
111000000000111
110000000000011
100001111100001
110000111000011
111000010000111
111100000001111
111110000011111
111111000111111
111111111111 11
